##########........@.......##########
##########................##########
##########..........###...##########
##########................##########
##########....###.........##########
##########................##########
####################################
####################################
####################################
####################################
####################################
####################################