%%%%%%%%%%%%%%%%%%%%%%%%%%%%%%%%%%%%
%%%%%%%%%%%%%%%%%%%%%%%%%%%%%%%%%%%%
%%%%%%%%%%%%%%%%%%%%%%%%%%%%%%%%%%%%
%%%%%%%%%%%%%%%%%%%%%%%%%%%%%%%%%%%%
%%%%%%%%%%%%%%%%%%%%%%%%%%%%%%%%%%%%
%%%%%%%%%%.--------------.%%%%%%%%%%
##########................##########
##########................##########
##########................##########
##########...........##...##########
##########................##########
##########.....###........##########
##########..............############
#############.............##########
##########...........###..##########
##########................##########
##########...###..@.......##########
##########................##########
##########..........###...##########
##########................##########
##########....###.........##########
##########................##########
####################################
####################################
####################################
####################################
####################################
####################################