%%%%%%%%%%.--------------.%%%%%%%%%%
%%%%%%%%%%.--------------.%%%%%%%%%%
%%%%%%%%%%.--------------.%%%%%%%%%%
%%%%%%%%%%.--------------.%%%%%%%%%%
%%%%%%%%%%.--------------.%%%%%%%%%%
%%%%%%%%%%.--------------.%%%%%%%%%%
%%%%%%%%%%................%%%%%%%%%%
%%%%%%%%%%................%%%%%%%%%%
%%%%%%%%%%................%%%%%%%%%%
%%%%%%%%%%...........%%...%%%%%%%%%%
%%%%%%%%%%................%%%%%%%%%%
%%%%%%%%%%.....%%%........%%%%%%%%%%
%%%%%%%%%%..............%%%%%%%%%%%%
%%%%%%%%%%%%%.............%%%%%%%%%%
%%%%%%%%%%...........%%%..%%%%%%%%%%
%%%%%%%%%%................%%%%%%%%%%
%%%%%%%%%%...%%%..........%%%%%%%%%%
%%%%%%%%%%................%%%%%%%%%%
%%%%%%%%%%..........%%%...%%%%%%%%%%
%%%%%%%%%%................%%%%%%%%%%
%%%%%%%%%%....%%%.........%%%%%%%%%%
%%%%%%%%%%..........@.....%%%%%%%%%%
%%%%%%%%%%%%%%%%%%%%%%%%%%%%%%%%%%%%
%%%%%%%%%%%%%%%%%%%%%%%%%%%%%%%%%%%%
%%%%%%%%%%%%%%%%%%%%%%%%%%%%%%%%%%%%
%%%%%%%%%%%%%%%%%%%%%%%%%%%%%%%%%%%%
%%%%%%%%%%%%%%%%%%%%%%%%%%%%%%%%%%%%
%%%%%%%%%%%%%%%%%%%%%%%%%%%%%%%%%%%%